11111111111111111111111111111
10000000000000000000000000001
1000000000E000000000000000001
10000000000000000000000000001
10000000011100000000000000001
10000000010100000000000000001
10000000011100000000000000001
10000000000000000000000000001
10000000000000000000000000001
10000000000C00000000000000001
10000000000000000000000000001
10000000000000000000000000001
10000000000000000000000000001
10000000000000000000000000001
10000000000000000000000000001
10000000000000000000000000001
10000000000000000000000000001
10000000000000000000000000001
10000000000000000000000000001
10000000000000000000000000001
10000000000000000000000000001
10000000000000000000000000001
10000000000000000000000000001
10000000000000000000000000001
10000000000000000000000000001
10000000000000000000000000001
10000000000000000000000000001
10000000000000000000000000001
100000000000000000000000000P1
11111111111111111111111111111
