11111111111111111
10000000000000001
1000000E00000C001
10000000000000001
10000001100000001
10000000100000001
10000011100000001
10000000P00000001
100C0000000000001
10000000000000001
10000000100000001
10000000000000001
10000000000000001
11111111111111111
