11111111111111111111
1P00C00000000C000001
10000000000000000001
10000000000000000001
100000000000000000C1
10000000000000000001
10000000C00000000001
10000000000000000001
10000000000000000001
100000000000000C0001
10000000000000000001
1C000000000000000001
1E000000000000000001
10000000000000000001
1000000C000000000001
100000000000000000C1
10000000000000000001
10000000000000000001
100000000C0000000001
10000000000000000001
10000000000000000Z01
1000C000000000000001
10111111111111111111
10000000000000000001
10000000000000000001
100000000C0000000001
10000000000000000001
11111111111111111101
1000000000000000C001
1C000000000000000001
11111111111111111111
