11111111111111111111
1CCCCCCCCCCCCCCCCCC1
1CCCCCCCCCECCCCCCCC1
1CCCCCCCCCCCCCCCCCC1
1CCCCCCCC111CCCCCCC1
1CCCCCCCC101CCCCCCC1
1CCCCCCCC111CCCCCCC1
1CCCCCCCCCCPCCCCCCC1
1CCCCCCCCCCCCCCCCCC1
1CCCCCCCCCCCCCCCCCC1
1CCCCCCCCCCCCCCCCCC1
1CCCCCCCCCCZCCCCCCC1
1CCCCCCCCCCCCCCCCCC1
1CCCCCCCCCCCCCCCCCC1
1CCCCCCCCCCCCCCCCCC1
1CCCCCCCCCCCCCCCCCC1
11111111111111111111
