11111111111111111111
10000000000000000001
1000000000E000000000
10000000000000000001
10000000011100000001
10000000010100000001
10000000011100000001
10000000000P00000001
100C0000000000000001
10000000000000000001
10000000000000000001
10000000000Z00000001
10000000000000000001
10000000000000000001
10000000000000000001
10000000000000000001
11111111111111111111
